brains,meninx,meninges,hippocampus,subventricular zone,ventromedial hypothalamus,cerebral cortex,motor cortex,thalamus,hypothalamus,neocortex,corpus callosum,cerebrospinal fluid,somatosensory cortex,prefrontal cortex,cerebellar nuclei,choroid plexus,subpallium,striatum,pituitary,white matter,diencephalon,dorsolateral prefrontal cortex,gliomas,glioma,brain,dentate gyrus,Purkinje cell,preoptic hypothalamus,Ventromedial hypobrain,cerebellum,skull,medial vestibular nucleus,medial vestibular,Superior colliculus,middle temporal gyrus,meningeal,ateral geniculte nucleus,NSCs,subventricular zone SVZ,subventricular zone(SVZ),SVZ,PFC,hypothalamic paraventricular nucleus,paraventricular,ventricular-subventricular zone,ventricular-subventricular zone,frontal isocortex,frontal lobe,telencephalic,habenula,lateral habenula,medial habenula,whole cortex,cortex,pallium,Hippocampal,cerobrospinal fluid,cranial dura,Cranial,dura,cerebellar,caudate nucleus,putamen,Caudate putamen,ependymoma,Thalamic,thalamic reticular nucleus,pontine nuclei,Substantia nigra,Posterior fossa,anterior pituitary,Medial amygdala,MeA,temporal,vmhvl,glioblastoma,GBM,head,heads,Calvaria,hair,scalp,calvariae,central nervous system,nervous system,CNS,Dura-derived,CSF,PCNSL,brainstem dorsal vagal complex,neuroblastoma,spinal dura,spinal cords,spinal cord,Cervical spinal cord,midbrain	brain
bones,iliac crest,bone,Lumbar intervertebral disc,intervertebral disc,Periosteum,tibiae,femura,joints,synovial,joint,synovium,Synovial membrane,rheumatoid arthritis,rheumatoid arthritis RA,articular cartilage of talus,knees,anterior cruciate ligament,knee,cartilages,cartilage,limb cartilage,Articular cartilage,lumbar,spine,lumbosacral spinal cord,ligament	bone
plasma,hematopoietic,hematopoietics,megakaryocyte,megakaryocytes,erythroid,erythrocyte,erythrocytes,serum,peripheral blood,leukocytes,leukocyte,venous blood,dendritic,neutrophil,neutrophils,delta,blood,heparinized blood,cord blood,erythroblasts,erythroblast,platelets,platelet,leukemias,leukemia,myelogenous leukemia,PBL,TILs,pbmcs,pbmc,PBMC,peripheral blood mononuclear cell,lymphoid,myeloid,lymphomas,lymphoma	blood
marrows,nucleus pulposus,bone marrow,Marrow,Marrows,Central marrow stroma,marrow stroma,intramedullary canal,myelomas,myeloma	bone marrow
skins,foreskin,dorsal skin,endothelial,endoderm,endothelium,epithelial,basal,epithelium,interfollicular epidermis,epidermis,melanomas,melanoma,skin,dermis,hair follicles	skin
cardiomyocytes,cardiomyocyte,cardiac,endocardial,hearts,left ventricle,myocardium,atrium,epicardial,right ventricle,ventricles,ventricle,heart,Myocardial infarction,Myocardium,Left Ventricle,Left ventricular apex,left atrium,right atrium,ventricular chambers,ventricular,Interventricular septum,Interventricular,atrial	heart
cerebral organoids,organoid,PDX	organoid
adipose,fats,fat,adipocytes,adipocyte,visceral adipose tissue,adipose,Subcutaneous adipose,subcutaneous hepatocellular tumor,Subcutaneous WAT,perivascular adipose tissue,PVAT,brown adipose,BAT,gonadal adipose,GAT,MAT,Mesenteric adipose,SCAT,subcutaneous adipose tissue,inguinal pad	adipose
mouths,tongue,tongues,vocal cord,vocal cords,mouth,molar,molars,incisor,incisors,tooth,dental pulps,dental pulp,dental follile,mandibular molars,oral cavity,Oropharynx,mandibular arch,mandibular,Gingiva,Anterior Palate,Buccal,Oral Mucosa,periodontium,odontogenic keratocyst,soft periodontal,palate,temporomandibular	oral cavity
livers,hepatic,bile duct,fetal livers,fetal liver,liver,gallbladder,Gall-Bladder,extrahepatic duct,liver sinusoid,hepatocytes,biliary,intrahepatic cholangiocyte,hepatcellular	liver
capillary,vessels,vessel,vein,veins,umbilical veins,umbilical vein,aortas,aorta,aortic,artery,ascending aorta,aortic valve,aortic root,thoracic aorta,brachiocephalic artery,Abdominal Aorta,aortic arch,Aorta thoracic,vitelline arteries,umbilical aorta,atherosclerotic aorta,atherosclerotic,Vascular,coronary artery,vessel mensicus,aortic adventitia,Atherosclerotic aoric arch,atheromas,carotid,Coronary,Coronary Atherosclerotic,carotid artery	vessel
nerve,sciatic nerve,neurons,neural,oligodendrocytes,oligodendrocyte,lateral ganglionic eminence,lateral ganglionic eminences,ganglion,ganglions,interneuron,interneurons,astrocytes,astrocyte,medial ganglionic eminences,medial ganglionic eminence,microglial,dorsal root ganglion,dorsal root ganglia,neuron,Facial_nerve,face nerve,dorsal raphe nucleus,myenteric plexus,Sympathoadrenal system	peripheral nerve
embryonic,embryos,fetus,primitive streak,morula,presomitic mesoderm,extra-embryonic mesoderm,blastomeres,blastomere,embryoid body,epiblast,placenta,mesoderm,trophoblasts,trophoblast,umbilical cord，ectoderm,primordial germ,germinal centers,germinal center,germ,trophectoderm,inner cell mass,amniotic fluid,embryo,preimplantation embryo,posterior embryo,Yolk sac and Placenta,yolk sac,Mouse Embryonic Fibroblasts,MEFs,spermatogonial,blastocyst,gastruloids,Gastrulation,trophoblast,whartons jelly,gonads,gonad,pluripotent stem cells,HPSC,pluripotent stem cell,iPSCs,HPSCs,pharyngeal mesoderm,oocyte,oocytes,placental villi	embryo
salivary glands,salivary glands,glands,acinar,labial minor salivary gland,primary salivary gland,Submandibular Salivary Gland,submandibular gland,SMG,Arenal Gland,Adenoma,parathyroid gland	glands
hindlimb,hindlimbs,hind limb,hind limbs,limbs,arms,arm,legs,limb,leg,Skoog's fascia,dorsal mid-forearm,femur,plate femurs,femurs,femur,tibia,epiphyses,inguinal,axillary,digit tip,nail,nails,foot,hip,palm,hind leg,left flank	limb
muscles,skeletal muscle,skeletal muscles,smooth muscle,muscle,Gastrocnemius muscle,Fetus muscle,IrisMuscle,Leg Muscle,limb muscle,lower abdominal muscle,Muscularis externae,Neonatalmuscle,plantaris muscle,Quadriceps muscle,Semitendinosus muscle,temporal,myogenic cells,myofiber,myobundle,myoblast,myotube nuclei,tendon,Quadriceps,Tibialis anterior,Tibialis,Vastus lateralis,flesh,rhabdomyosarcoma	muscle
fetal lung,fetal lungs,lungs,left lobe，left lobes,bronchoalveolar lavage,lung,left lung lobe,pulmonary,Bronchoalvaolar,Bronchoalveolar,Bronchus,alveolospheres,Bronchial,Diaphragm	lung
colons,colon,colorectal,ascending colon,colorectal polyps,distal colon,descending colon,Duodenum,Jejunum,Ileum,Transverse Colon,Rectal,Colorectal,colectomy,bowel,Sigmoid,paneth,Paneth cell	colon
airways,trachea,tracheas,bronchi,pharynx,airway,Bronchiole	airway
nasal,nasal polyp,noses,polyps,polyp,nasal mucosa,nose,olfactory,Vomeronasal sensory epithelium,Nasal cavity,vomeronasal epithelium,olfactory epithelium,Middle Turbinate,Nasopharyngal,nasopharyngeal	nose
ears,inner ear,ear,inner ears,cochlea,tympanic membrane,Otic Vesicle,Cochlear,Cochlear stria vascularis,Stria Vascularis,middle ear mucosal tissue,middle ear,utricle,crista ampullaris,peri-otic,otic,Pinna,auricular	ear
kidneys,urine,urethra,adrenal gland,kidney,adrenal glands,nephron,mesonephros,glomerulus,nephric duct spheroid,Cortical kidney,unilateral urether,Kidney glomerulus,Kidney Medulla,Kidney Tubuloids,glomeruli,Renal cell,adrenal,renal,urothelial	kidney
pancreatic,pancreas,pancreatic ductal,islet,PDAC	pancreas
ovarian follicles,ovarian,granulosa,pelvic cavity,fetal ovary,ovary,Ovary,Fallopian tube,Oviduct,Fallopiantube,Follicle,periovarian,oviducts,Vagina,Vaginal apex,pelvic cavity	ovary
Uterus,Endocervix,cervix,Ectocervix,endometrial,Myometrium,Decidua,endometrium,Endometriosis,uterine,Omentum,cervical,hec-1-b	uterus
progenitors,progenitor,mesenchymal,luminal,secretory,tufts,tuft,goblet,pit	none
primary visual cortex,eyes,choroid,conjunctiva,cornea,rods,rod,retinal,eye,retina,anterior eye segment,limbus rim,limbus,Iridocorneal angle,Cone,cones,photoreceptors,Retinal,Retinal Microglia,Persistent Fetal Vasculature PFV,Persistent Fetal Vasculature,PFV,Ocular,lacrimal gland,conjunctival tissue,iris,retinal pigment epithelium,RPE,neural retina,Peripheral retina,Sclera,corneoscleral,corneal	eye
prostates,prostate,pididymal,prostatic	prostate
bladders,bladder,gallbladder,urothelium,ureter,urinary bladder,urogenital sinus,blader	bladder
lymphatic vessels,lmpps,lmpp,germinal centers,lymph,germinal center,Axillary lymph node,mesenteric lymph nodes,mesenteric lymph node,mesenteric lymph,Renal hilus lymph,inguinal LN,inguinal lymph node,Germinal center	lymph
tonsils,amygdala,tonsil	tonsil
spermatogonium,sperm,sertoli,testis,testes,Corpus Cavernosum,penis,external genitalia,epididmis,epididymis	testis
carcinomas,carcinoma	carcinoma
intestine,guts,gut,foregut endoderm,rectum,small intestine,small intestines,large intestine,large intestines,intestines,intestinal crypt,intestinal crypts,small intestinal crypt,small intestinal crypts,ileum,jejunum node,duodenum,caecum,ileal	intestine
necks,neck,thyroids,thyroid,pharyngeal arch,larynx,Laryngeal,LSCC	neck
spleens,spleen,splenocytes,Splenic	spleen
esophageal,esophagus,OE33 commercial cells,EAC,esophageal adenocarcinoma	esophagus
sarcomas,sarcoma,soft tissue	soft tissue
malignant pleural effusion,pleural,pleura,mammary glands,breast,mammary gland,rib,gland,mammary tumor,spontaneous breast,mammary fat-pad tumor,Mammary,ductal,TNBC,Triple negtive breast cancer	breast
thoracic thymus,normal thymus,mouse thymus,Thymus,thymus,cervical thymus,thymus cells,embryo Thymus,thymocytes,thymic	thymus
peritoneum,ascites,ascite,abdomen,abdominal aortic aneurysm,Peritoneum,peritoneal cavity,Peritoneum,Mesentery,Omentum,Peritoneal,intraperitoneal Fluid,peritoneal cavity,Peritoneal dialysis fluid,Peritoneal fluids,Peritoneal lavage fluid,Peritoneal lavage,Omental,omenta,Ventral	ascites
gastric,stomach,Gastrointestinal,antrum,gastric gland	stomach
